1,1,1,1,2,1,2,0,2
1,2,1,0,1,1,2,1,2
1,3,1,0,0,0,2,1,2
1,4,1,1,0,1,2,0,2
1,5,1,0,1,0,2,1,2
1,6,1,1,0,1,2,0,2
1,7,1,0,1,1,2,0,2
1,8,1,0,0,1,2,1,2
1,9,1,0,0,1,2,1,2
1,10,1,2,0,1,2,0,2
2,1,1,1,2,0,1,0,2
2,2,1,0,1,1,1,0,2
2,3,1,1,0,1,0,1,2
2,4,1,1,1,0,1,0,2
2,5,1,0,1,1,0,1,2
2,6,1,0,0,1,1,1,2
2,7,1,0,0,1,1,1,2
2,8,1,1,0,0,1,1,2
2,9,1,0,1,1,1,0,2
2,10,1,2,0,0,1,1,2
3,1,1,1,2,0,0,1,2
3,2,1,0,1,0,1,1,2
3,3,1,0,0,1,1,1,2
3,4,1,0,0,1,0,1,2
3,5,1,1,0,0,1,1,2
3,6,1,0,1,0,1,0,2
3,7,1,1,0,1,1,1,2
3,8,1,1,1,0,0,1,2
3,9,1,0,1,0,1,1,2
3,10,1,2,0,1,0,1,2
4,1,1,1,2,2,0,0,2
4,2,1,1,1,2,0,1,2
4,3,1,0,1,2,1,0,2
4,4,1,0,0,2,1,1,2
4,5,1,1,0,2,0,1,2
4,6,1,1,1,2,0,0,2
4,7,1,0,1,2,1,0,2
4,8,1,1,0,2,0,1,2
4,9,1,0,1,2,0,0,2
4,10,1,2,0,2,1,1,2
1,1,2,0,2,1,2,1,0
1,2,2,1,0,0,2,1,1
1,3,2,0,1,0,2,1,1
1,4,2,1,0,1,2,1,0
1,5,2,0,1,1,2,0,1
1,6,2,1,0,1,2,1,0
1,7,2,1,1,0,2,0,0
1,8,2,0,1,0,2,1,1
1,9,2,1,0,1,2,0,1
1,10,2,2,1,0,2,0,0
2,1,2,1,2,1,1,0,0
2,2,2,1,1,1,0,1,0
2,3,2,1,1,0,0,1,1
2,4,2,1,1,0,1,1,0
2,5,2,1,1,0,1,0,1
2,6,2,1,1,1,1,0,1
2,7,2,1,1,1,0,0,1
2,8,2,1,1,0,0,1,1
2,9,2,1,1,1,1,0,0
2,10,2,2,1,1,0,1,1
3,1,2,0,2,0,1,1,1
3,2,2,1,0,0,1,1,1
3,3,2,1,1,1,0,0,1
3,4,2,1,1,1,0,1,1
3,5,2,1,1,1,0,0,1
3,6,2,0,1,1,1,1,0
3,7,2,1,0,0,1,1,1
3,8,2,1,1,0,0,1,1
3,9,2,0,1,1,1,0,1
3,10,2,2,0,0,1,1,1
4,1,2,1,2,2,0,1,0
4,2,2,1,1,2,0,0,1
4,3,2,0,1,2,1,0,0
4,4,2,0,0,2,1,1,1
4,5,2,0,0,2,1,1,1
4,6,2,1,0,2,1,0,0
4,7,2,1,1,2,0,1,0
4,8,2,0,1,2,0,1,1
4,9,2,1,0,2,1,1,0
4,10,2,2,1,2,0,0,1
1,1,3,0,2,1,2,2,1
1,2,3,0,0,1,2,2,1
1,3,3,0,0,1,2,2,1
1,4,3,0,0,1,2,2,1
1,5,3,1,0,0,2,2,0
1,6,3,0,1,0,2,2,1
1,7,3,1,0,1,2,2,0
1,8,3,0,1,0,2,2,1
1,9,3,1,0,1,2,2,0
1,10,3,2,1,1,2,2,0
2,1,3,0,2,0,1,2,0
2,2,3,0,0,1,1,2,1
2,3,3,0,0,1,1,2,1
2,4,3,1,0,0,1,2,1
2,5,3,1,1,1,0,2,0
2,6,3,1,1,0,0,2,0
2,7,3,0,1,1,1,2,0
2,8,3,1,0,1,0,2,1
2,9,3,0,1,1,1,2,0
2,10,3,2,0,0,1,2,1
3,1,3,1,2,0,0,2,1
3,2,3,0,1,0,1,2,1
3,3,3,1,0,1,1,2,0
3,4,3,1,1,0,0,2,1
3,5,3,1,1,0,1,2,0
3,6,3,0,1,1,0,2,1
3,7,3,0,0,1,1,2,1
3,8,3,1,0,1,1,2,1
3,9,3,1,1,0,1,2,0
3,10,3,2,1,0,0,2,1
4,1,3,1,2,2,0,2,1
4,2,3,1,1,2,0,2,0
4,3,3,1,1,2,1,2,0
4,4,3,0,1,2,0,2,1
4,5,3,1,0,2,0,2,1
4,6,3,0,1,2,1,2,0
4,7,3,0,0,2,1,2,1
4,8,3,0,0,2,1,2,1
4,9,3,1,0,2,0,2,1
4,10,3,2,1,2,0,2,0
