1,1,1,2,0,2
1,2,0,1,0,2
1,3,1,0,1,2
1,4,0,1,0,2
1,5,2,0,0,2
2,1,1,2,0,0
2,2,0,1,0,0
2,3,0,0,1,1
2,4,1,0,1,0
2,5,2,1,0,0
3,1,1,2,0,0
3,2,0,1,1,0
3,3,0,0,0,1
3,4,1,0,1,1
3,5,2,1,0,0
4,1,1,2,0,0
4,2,0,1,0,1
4,3,1,0,1,0
4,4,0,1,0,1
4,5,2,0,1,0
5,1,1,2,0,0
5,2,0,1,1,0
5,3,1,0,1,1
5,4,0,1,1,0
5,5,2,0,0,1
6,1,0,2,1,0
6,2,0,0,1,1
6,3,0,0,1,1
6,4,0,0,1,1
6,5,2,0,0,0
7,1,0,2,2,1
7,2,0,0,2,1
7,3,0,0,2,1
7,4,0,0,2,1
7,5,2,0,2,0
